#####################
#S..#...............#
#.#.#.###.#########.#
#.#...#.....#.......#
#.#.###.###.#.#####.#
#.#.#...#...#.#.....#
#.#.#.###.###.#.###.#
#...#.#.....#.#.#...#
###.#.#.###.#.#.#.###
#...#.#.#...#.#.#...#
#.###.#.#.###.#.###.#
#.#...#.#.#...#.....#
#.#.#####.#.#######.#
#.#.......#.........#
#.#######.#########.#
#.................#G#
#####################
